與	AG
不	AH
大	AK
雨	A,
小	DK
痕	HH
再	JJ
等	LL
性	NN
段	SS
畫	TT
樂	XL
診	YY
個	;;
漂	//
資	KM
的	T
黨	C,
崇	DC
岸	DF
朝	FU
葉	FV
驅	G;
旅	HK
弟	KL
察	NC
序	ND
突	NH
賽	NM
容	N;
矩	OT
物	O.
圍	PQ
輯	QE
融	Q/
場	R.
費	TM
選	TN
她	WS
綻	XC
被	YB
刻	YE
熟	Y,
歷	ZE
厲	ZM
壓	ZR
乳	.S
單	;F
還	/N
業	CA
深	CJ
淨	C.
歲	EZ
倉	IT
佛	KT
唐	NT
憐	N,
態	XU
語	YA
享	Y;
盛	ZG
須	.A
徹	.Z
啊	;T
耐	AJ
聖	A;
壁	BY
普	IA
幡	JL
價	K/
廣	NP
悔	NS
室	NX
慌	NY
城	RG
越	RQ
艱	RT
跑	ST
跨	SA
婚	WA
編	XJ
裝	XY
繪	X/
讀	Y/
高	YJ
煤	,A
徜	.J
復	.P
貴	;A
罷	/U
餿	BO
廢	BT
飯	BZ
帳	DQ
繫	DS
臣	DT
條	D.
聰	EL
慶	GN
視	HJ
游	HO
神	HP
祖	HU
祝	H;
剛	ID
網	JI
考	LA
般	MS
航	MY
喝	PL
範	QG
遮	R,
憲	R/
歉	TC
掃	TJ
租	VU
魏	VW
率	X,
源	ZL
浮	.G
馳	,G
救	,H
釋	,/
靠	;E
嘉	;I
遠	;L
飄	/A
叔	AB
插	AO
期	AU
耀	AY
飾	BD
辭	BF
澄	BI
頗	BM
概	BS
餘	BV
端	DE
頂	DM
監	DU
候	DZ
臨	D;
寂	EB
嘴	EJ
潤	ER
據	E.
禮	HI
貿	HM
祇	HS
儀	IX
嘗	JP
盜	JU
窮	KG
殘	MX
乾	PS
鄭	PT
呀	QL
框	QR
築	QV
席	RD
謀	RV
贊	SM
恐	SN
望	SR
繁	SX
敏	S.
衛	TD
婆	TW
靜	UD
俱	UK
術	VD
科	VF
頸	WM
倚	ZD
短	ZI
矮	ZW
隆	.R
騎	,D
璧	;H
票	/C
裂	EX
實	FM
漲	GX
敦	G.
邀	HN
榮	JV
姿	JW
夏	J.
惰	QU
熊	Q,
盤	SU
昏	SP
輝	SQ
擁	SY
鑒	TI
魘	UX
貸	XM
璃	YM
環	/X
倒	XE
堅	TR
恥	AN
死	AQ
展	BX
沈	CS
卓	EF
直	FA
那	GT
鈉	IK
但	KA
利	LE
秉	LT
委	LW
度	NB
宇	NF
情	NU
質	OM
是	PC
陳	TP
改	T.
君	T;
材	VL
妙	WL
姓	WR
妹	WV
組	XA
部	YT
請	YU
秦	ZV
逢	.N
唱	;P
予	BG
尾	BL
清	CR
雇	GK
仲	K;
首	IL
會	I/
急	JT
我	LO
家	NA
表	RL
陪	TY
姐	WU
始	WX
紀	XT
詞	YG
衣	YL
狗	.L
躬	.T
朗	BU
牙	DL
在	DR
孔	FS
戒	FX
社	HR
遇	MN
你	JC
刺	JE
息	JN
索	JX
虐	QA
妄	SW
退	XN
集	YV
番	,P
造	;N
妳	WJ
罵	/,
哪	;G
轉	QF
碟	GV
假	ET
喔	BA
獎	MH
聯	EW
每	SO
沒	LC
龍	UY
光	SC
受	B.
嗚	,;
溫	UC
取	BE
隊	.I
議	IY
次	JA
例	MK
活	FC
試	QY
球	HA
雄	YZ
鳳	,S
謝	HY
題	MP
晚	SJ
傳	HZ
觀	S;
吧	SD
希	DJ
窗	HL
項	ML
夢	MJ
英	EG
影	MV
您	U/
貓	.C
圖	TU
魔	MO
基	GE
件	GW
辦	BW
元	UW
換	HW
雲	UZ
提	TO
檔	DV
景	GP
建	GB
莫	M/
三	S/
標	B/
客	KW
團	TZ
底	DH
掉	DW
調	D,
交	GI
幹	G/
何	HC
凰	HE
哈	HG
呵	HV
完	WT
玩	WK
惡	W/
教	MG
讓	MZ
板	MB
覺	MA
理	MI
參	MW
訊	MF
至	MR
幫	MD
市	XD
章	UF
卻	UJ
怎	UN
者	UP
商	U;
速	UV
保	TV
討	,T
錄	,L
代	,I
許	,U
冷	,B
卡	,C
管	,E
歌	,K
式	,X
笑	,Z
戀	/L
統	/T
意	/I
協	/B
打	/D
灣	/G
守	/H
其	/K
佳	/R
按	/W
喜	/;
究	UG
啦	UL
演	WE
若	WZ
界	TA
需	.U
線	QW
錢	RW
歡	FW
戰	;W
整	VT
阿	T,
引	T/
徵	O/
星	P/
版	D/
程	L/
感	Z/
舍	UM
尚	UT
站	,M
